Date,Day,Month,New Cases,New Death,Total Recoverd,New Recovered,Total Death,Total Cases,Active Cases,year
2020-03-15,Sunday,3,16,0,26,0,2,126,98,2020
2020-03-16,Monday,3,40,2,26,0,4,166,136,2020
2020-03-17,Tuesday,3,30,2,26,0,6,196,164,2020
2020-03-18,Wednesday,3,14,0,28,2,6,210,176,2020
2020-03-19,Thursday,3,46,1,28,0,7,256,221,2020
2020-03-20,Friday,3,29,1,39,11,8,285,238,2020
2020-03-21,Saturday,3,9,2,41,2,10,294,243,2020
2020-03-22,Sunday,3,33,4,56,15,14,327,257,2020
2020-03-23,Monday,3,39,5,68,12,19,366,279,2020
2020-03-24,Tuesday,3,36,1,80,12,20,402,302,2020
2020-03-25,Wednesday,3,54,1,93,13,21,456,342,2020
2020-03-26,Thursday,3,39,3,102,9,24,495,369,2020
2020-03-27,Friday,3,41,6,116,14,30,536,390,2020
2020-03-28,Saturday,3,40,6,121,5,36,576,419,2020
2020-03-29,Sunday,3,33,4,132,11,40,609,437,2020
2020-03-30,Monday,3,47,1,150,18,41,656,465,2020
2020-03-31,Tuesday,3,54,5,157,7,46,710,507,2020
2020-01-04,Wednesday,1,69,6,179,22,52,779,548,2020
2020-02-04,Thursday,2,86,6,201,22,58,865,606,2020
2020-03-04,Friday,3,120,8,216,15,66,985,703,2020
2020-04-04,Saturday,4,85,5,241,25,71,1070,758,2020
2020-05-04,Sunday,5,103,7,247,6,78,1173,848,2020
2020-06-04,Monday,6,149,7,259,12,85,1322,978,2020
2020-07-04,Tuesday,7,128,9,276,17,94,1450,1080,2020
2020-08-04,Wednesday,8,110,9,305,29,103,1560,1152,2020
2020-09-04,Thursday,9,139,15,348,43,118,1699,1233,2020
2020-10-04,Friday,10,95,17,384,36,135,1794,1275,2020
2020-11-04,Saturday,11,145,11,426,42,146,1939,1367,2020
2020-12-04,Sunday,12,126,13,447,21,159,2065,1459,2020
2020-04-13,Monday,4,125,5,488,41,164,2190,1538,2020
2020-04-14,Tuesday,4,160,14,514,26,178,2350,1658,2020
2020-04-15,Wednesday,4,155,5,553,39,183,2505,1769,2020
2020-04-16,Thursday,4,168,13,596,43,196,2673,1881,2020
2020-04-17,Friday,4,171,9,646,50,205,2844,1993,2020
2020-04-18,Saturday,4,188,19,701,55,224,3032,2107,2020
2020-04-19,Sunday,4,112,15,732,31,239,3144,2173,2020
2020-04-20,Monday,4,189,11,821,89,250,3333,2262,2020
2020-04-21,Tuesday,4,157,14,870,49,264,3490,2356,2020
2020-04-22,Wednesday,4,169,12,935,65,276,3659,2448,2020
2020-04-23,Thursday,4,232,11,1004,69,287,3891,2600,2020
2020-04-24,Friday,4,201,7,1075,71,294,4092,2723,2020
2020-04-25,Saturday,4,227,13,1114,39,307,4319,2898,2020
2020-04-26,Sunday,4,215,10,1176,62,317,4534,3041,2020
2020-04-27,Monday,4,248,20,1236,60,337,4782,3209,2020
2020-04-28,Tuesday,4,260,22,1304,68,359,5042,3379,2020
2020-04-29,Wednesday,4,226,21,1335,31,380,5268,3553,2020
2020-04-30,Thursday,4,269,12,1381,46,392,5537,3764,2020
2020-01-05,Friday,1,358,14,1460,79,406,5895,4029,2020
2020-02-05,Saturday,2,298,9,1522,62,415,6193,4256,2020
2020-03-05,Sunday,3,272,14,1562,40,429,6465,4474,2020
2020-04-05,Monday,4,348,7,1632,70,436,6813,4745,2020
2020-05-05,Tuesday,5,388,16,1730,98,452,7201,5019,2020
2020-06-05,Wednesday,6,387,17,1815,85,469,7588,5304,2020
2020-07-05,Thursday,7,393,13,1887,72,482,7981,5612,2020
2020-08-05,Friday,8,495,21,1945,58,503,8476,6028,2020
2020-09-05,Saturday,9,488,11,2002,57,514,8964,6448,2020
2020-10-05,Sunday,10,436,11,2075,73,525,9400,6800,2020
2020-11-05,Monday,11,346,8,2172,97,533,9746,7041,2020
2020-12-05,Tuesday,12,347,11,2326,154,544,10093,7223,2020
2020-05-13,Wednesday,5,338,12,2486,160,556,10431,7389,2020
2020-05-14,Thursday,5,398,15,2626,140,571,10829,7632,2020
2020-05-15,Friday,5,399,21,2799,173,592,11228,7837,2020
2020-05-16,Saturday,5,491,20,2950,151,612,11719,8157,2020
2020-05-17,Sunday,5,510,18,3172,222,630,12229,8427,2020
2020-05-18,Monday,5,535,15,3440,268,645,12764,8679,2020
2020-05-19,Tuesday,5,720,14,3742,302,659,13484,9083,2020
2020-05-20,Wednesday,5,745,21,3994,252,680,14229,9555,2020
2020-05-21,Thursday,5,774,16,4217,223,696,15003,10090,2020
2020-05-22,Friday,5,783,11,4374,157,707,15786,10705,2020
2020-05-23,Saturday,5,727,28,4628,254,735,16513,11150,2020
2020-05-24,Sunday,5,752,29,4807,179,764,17265,11694,2020
2020-05-25,Monday,5,702,19,4900,93,783,17967,12284,2020
2020-05-26,Tuesday,5,789,14,5027,127,797,18756,12932,2020
2020-05-27,Wednesday,5,910,19,5205,178,816,19666,13645,2020
2020-05-28,Thursday,5,1127,29,5359,154,845,20793,14589,2020
2020-05-29,Friday,5,1289,34,5511,152,879,22082,15692,2020
2020-05-30,Saturday,5,1367,34,5693,182,913,23449,16843,2020
2020-05-31,Sunday,5,1536,46,6037,344,959,24985,17989,2020
2020-01-06,Monday,1,1399,46,6447,410,1005,26384,18932,2020
2020-02-06,Tuesday,2,1152,47,6827,380,1052,27536,19657,2020
2020-03-06,Wednesday,3,1079,36,7350,523,1088,28615,20177,2020
2020-04-06,Thursday,4,1152,38,7756,406,1126,29767,20885,2020
2020-05-06,Friday,5,1348,40,8158,402,1166,31115,21791,2020
2020-06-06,Saturday,6,1497,32,8538,380,1198,32612,22876,2020
2020-07-06,Sunday,7,1467,39,8961,423,1237,34079,23881,2020
2020-08-06,Monday,8,1365,34,9375,414,1271,35444,24798,2020
2020-09-06,Tuesday,9,1385,35,9786,411,1306,36829,25737,2020
2020-10-06,Wednesday,10,1455,36,10289,503,1342,38284,26653,2020
2020-11-06,Thursday,11,1442,35,10691,402,1377,39726,27658,2020
2020-12-06,Friday,12,1577,45,11108,417,1422,41303,28773,2020
2020-06-13,Saturday,6,1677,62,11529,421,1484,42980,29967,2020
2020-06-14,Sunday,6,1618,91,11931,402,1575,44598,31092,2020
2020-06-15,Monday,6,1691,97,12329,398,1672,46289,32288,2020
2020-06-16,Tuesday,6,1567,94,12730,401,1766,47856,33360,2020
2020-06-17,Wednesday,6,1363,84,13141,411,1850,49219,34228,2020
2020-06-18,Thursday,6,1218,88,13528,387,1938,50437,34971,2020
2020-06-19,Friday,6,1774,79,13928,400,2017,52211,36266,2020
2020-06-20,Saturday,6,1547,89,14327,399,2106,53758,37325,2020
2020-06-21,Sunday,6,1475,87,14736,409,2193,55233,38304,2020
2020-06-22,Monday,6,1576,85,15133,397,2278,56809,39398,2020
2020-06-23,Tuesday,6,1332,87,15535,402,2365,58141,40241,2020
2020-06-24,Wednesday,6,1420,85,15935,400,2450,59561,41176,2020
2020-06-25,Thursday,6,1569,83,16338,403,2533,61130,42259,2020
2020-06-26,Friday,6,1625,87,16737,399,2620,62755,43398,2020
2020-06-27,Saturday,6,1168,88,17140,403,2708,63923,44075,2020
2020-06-28,Sunday,6,1265,81,17539,399,2789,65188,44860,2020
2020-06-29,Monday,6,1566,83,17951,412,2872,66754,45931,2020
2020-06-30,Tuesday,6,1557,81,18460,509,2953,68311,46898,2020
2020-01-07,Wednesday,1,1503,81,18881,421,3034,69814,47899,2020
2020-02-07,Thursday,2,1485,86,19288,407,3120,71299,48891,2020
2020-03-07,Friday,3,1412,81,19690,402,3201,72711,49820,2020
2020-04-07,Saturday,4,1324,79,20103,413,3280,74035,50652,2020
2020-05-07,Sunday,5,1218,63,20726,623,3343,75253,51184,2020
2020-06-07,Monday,6,969,79,21238,512,3422,76222,51562,2020
2020-07-07,Tuesday,7,1057,67,21718,480,3489,77279,52072,2020
2020-08-07,Wednesday,8,1025,75,22241,523,3564,78304,52499,2020
2020-09-07,Thursday,9,950,53,22753,512,3617,79254,52884,2020
2020-10-07,Friday,10,981,85,23274,521,3702,80235,53259,2020
2020-11-07,Saturday,11,923,67,23876,602,3769,81158,53513,2020
2020-12-07,Sunday,12,912,89,24419,543,3858,82070,53793,2020
2020-07-13,Monday,7,931,77,24975,556,3935,83001,54091,2020
2020-07-14,Tuesday,7,929,73,25544,569,4008,83930,54378,2020
2020-07-15,Wednesday,7,913,59,26135,591,4067,84843,54641,2020
2020-07-16,Thursday,7,928,53,26691,556,4120,85771,54960,2020
2020-07-17,Friday,7,703,68,27302,611,4188,86474,54984,2020
2020-07-18,Saturday,7,698,63,27868,566,4251,87172,55053,2020
2020-07-19,Sunday,7,603,51,28380,512,4302,87775,55093,2020
2020-07-20,Monday,7,627,50,28924,544,4352,88402,55126,2020
2020-07-21,Tuesday,7,676,47,29473,549,4399,89078,55206,2020
2020-07-22,Wednesday,7,667,41,30075,602,4440,89745,55230,2020
2020-07-23,Thursday,7,668,40,31066,991,4480,90413,54867,2020
2020-07-24,Friday,7,659,38,31970,904,4518,91072,54584,2020
2020-07-25,Saturday,7,511,40,32903,933,4558,91583,54122,2020
2020-07-26,Sunday,7,479,48,33831,928,4606,92062,53625,2020
2020-07-27,Monday,7,420,46,34838,1007,4652,92482,52992,2020
2020-07-28,Tuesday,7,465,39,35959,1121,4691,92947,52297,2020
2020-07-29,Wednesday,7,409,37,37025,1066,4728,93356,51603,2020
2020-07-30,Thursday,7,401,46,38236,1211,4774,93757,50747,2020
2020-07-31,Friday,7,321,31,39638,1402,4805,94078,49635,2020
2020-01-08,Saturday,1,238,29,41137,1499,4834,94316,48345,2020
2020-02-08,Sunday,2,167,31,42455,1318,4865,94483,47163,2020
2020-03-08,Monday,3,157,23,44066,1611,4888,94640,45686,2020
2020-04-08,Tuesday,4,112,24,45569,1503,4912,94752,44271,2020
2020-05-08,Wednesday,5,123,18,47182,1613,4930,94875,42763,2020
2020-06-08,Thursday,6,131,21,48898,1716,4951,95006,41157,2020
2020-07-08,Friday,7,141,20,50553,1655,4971,95147,39623,2020
2020-08-08,Saturday,8,167,21,51672,1119,4992,95314,38650,2020
2020-09-08,Sunday,9,178,17,52678,1006,5009,95492,37805,2020
2020-10-08,Monday,10,174,26,53779,1101,5035,95666,36852,2020
2020-11-08,Tuesday,11,168,24,54888,1109,5059,95834,35887,2020
2020-12-08,Wednesday,12,129,26,55901,1013,5085,95963,34977,2020
2020-08-13,Thursday,8,145,22,56890,989,5107,96108,34111,2020
2020-08-14,Friday,8,112,17,57858,968,5124,96220,33238,2020
2020-08-15,Saturday,8,116,17,58835,977,5141,96336,32360,2020
2020-08-16,Sunday,8,139,19,59743,908,5160,96475,31572,2020
2020-08-17,Monday,8,115,13,60651,908,5173,96590,30766,2020
2020-08-18,Tuesday,8,163,11,61562,911,5184,96753,30007,2020
2020-08-19,Wednesday,8,161,13,62553,991,5197,96914,29164,2020
2020-08-20,Thursday,8,111,15,63462,909,5212,97025,28351,2020
2020-08-21,Friday,8,123,19,64318,856,5231,97148,27599,2020
2020-08-22,Saturday,8,89,12,65118,800,5243,97237,26876,2020
2020-08-23,Sunday,8,103,19,65927,809,5262,97340,26151,2020
2020-08-24,Monday,8,138,18,66817,890,5280,97478,25381,2020
2020-08-25,Tuesday,8,141,18,67717,900,5298,97619,24604,2020
2020-08-26,Wednesday,8,206,19,68713,996,5317,97825,23795,2020
2020-08-27,Thursday,8,237,25,69612,899,5342,98062,23108,2020
2020-08-28,Friday,8,223,20,70419,807,5362,98285,22504,2020
2020-08-29,Saturday,8,212,14,71302,883,5376,98497,21819,2020
2020-08-30,Sunday,8,230,23,72120,818,5399,98727,21208,2020
2020-08-31,Monday,8,212,22,72929,809,5421,98939,20589,2020
2020-01-09,Tuesday,1,176,19,73828,899,5440,99115,19847,2020
2020-02-09,Wednesday,2,165,21,74626,798,5461,99280,19193,2020
2020-03-09,Thursday,3,145,18,75415,789,5479,99425,18531,2020
2020-04-09,Friday,4,157,16,76305,890,5495,99582,17782,2020
2020-05-09,Saturday,5,130,16,77208,903,5511,99712,16993,2020
2020-06-09,Sunday,6,151,19,78108,900,5530,99863,16225,2020
2020-07-09,Monday,7,178,11,79008,900,5541,100041,15492,2020
2020-08-09,Tuesday,8,187,19,79886,878,5560,100228,14782,2020
2020-09-09,Wednesday,9,175,17,80689,803,5577,100403,14137,2020
2020-10-09,Thursday,10,154,13,81597,908,5590,100557,13370,2020
2020-11-09,Friday,11,151,17,82473,876,5607,100708,12628,2020
2020-12-09,Saturday,12,148,20,83261,788,5627,100856,11968,2020
2020-09-13,Sunday,9,153,21,84161,900,5648,101009,11200,2020
2020-09-14,Monday,9,168,13,84969,808,5661,101177,10547,2020
2020-09-15,Tuesday,9,163,18,85745,776,5679,101340,9916,2020
2020-09-16,Wednesday,9,160,17,86549,804,5696,101500,9255,2020
2020-09-17,Thursday,9,141,19,87158,609,5715,101641,8768,2020
2020-09-18,Friday,9,131,18,87958,800,5733,101772,8081,2020
2020-09-19,Saturday,9,128,17,88666,708,5750,101900,7484,2020
2020-09-20,Sunday,9,115,20,89532,866,5770,102015,6713,2020
2020-09-21,Monday,9,126,17,90332,800,5787,102141,6022,2020
2020-09-22,Tuesday,9,113,19,91143,811,5806,102254,5305,2020
2020-09-23,Wednesday,9,121,16,91843,700,5822,102375,4710,2020
2020-09-24,Thursday,9,138,13,92644,801,5835,102513,4034,2020
2020-09-25,Friday,9,112,18,93531,887,5853,102625,3241,2020
2020-09-26,Saturday,9,111,16,94374,843,5869,102736,2493,2020
2020-09-27,Sunday,9,104,14,95080,706,5883,102840,1877,2020
2020-09-28,Monday,9,115,18,95568,488,5901,102955,1486,2020
2020-09-29,Tuesday,9,124,13,96094,526,5914,103079,1071,2020
2020-09-30,Wednesday,9,119,16,96494,400,5930,103198,774,2020
2020-01-10,Thursday,1,119,16,96855,361,5946,103317,516,2020
2020-02-10,Friday,2,149,10,97143,288,5956,103466,367,2020
2020-03-10,Saturday,3,109,14,97274,131,5970,103575,331,2020
2020-04-10,Sunday,4,108,11,97355,81,5981,103683,347,2020
2020-05-10,Monday,5,98,9,97398,43,5990,103781,393,2020
2020-06-10,Tuesday,6,121,11,97449,51,6001,103902,452,2020
2020-07-10,Wednesday,7,133,9,97492,43,6010,104035,533,2020
2020-08-10,Thursday,8,121,7,97524,32,6017,104156,615,2020
2020-09-10,Friday,9,106,12,97592,68,6029,104262,641,2020
2020-10-10,Saturday,10,125,11,97643,51,6040,104387,704,2020
2020-11-10,Sunday,11,129,12,97688,45,6052,104516,776,2020
2020-12-10,Monday,12,132,10,97743,55,6062,104648,843,2020
2020-10-13,Tuesday,10,139,9,97841,98,6071,104787,875,2020
2020-10-14,Wednesday,10,128,6,97920,79,6077,104915,918,2020
2020-10-15,Thursday,10,118,11,98011,91,6088,105033,934,2020
2020-10-16,Friday,10,126,11,98089,78,6099,105159,971,2020
2020-10-17,Saturday,10,138,10,98157,68,6109,105297,1031,2020
2020-10-18,Sunday,10,127,11,98247,90,6120,105424,1057,2020
2020-10-19,Monday,10,123,10,98314,67,6130,105547,1103,2020
2020-10-20,Tuesday,10,158,12,98413,99,6142,105705,1150,2020
2020-10-21,Wednesday,10,178,13,98516,103,6155,105883,1212,2020
2020-10-22,Thursday,10,177,11,98624,108,6166,106060,1270,2020
2020-10-23,Friday,10,170,10,98713,89,6176,106230,1341,2020
2020-10-24,Saturday,10,167,11,98813,100,6187,106397,1397,2020
2020-10-25,Sunday,10,143,12,98903,90,6199,106540,1438,2020
2020-10-26,Monday,10,167,12,98981,78,6211,106707,1515,2020
2020-10-27,Tuesday,10,170,11,99084,103,6222,106877,1571,2020
2020-10-28,Wednesday,10,153,12,99174,90,6234,107030,1622,2020
2020-10-29,Thursday,10,179,13,99273,99,6247,107209,1689,2020
2020-10-30,Friday,10,167,11,99353,80,6258,107376,1765,2020
2020-10-31,Saturday,10,179,8,99452,99,6266,107555,1837,2020
2020-01-11,Sunday,1,181,12,99555,103,6278,107736,1903,2020
2020-02-11,Monday,2,189,13,99652,97,6291,107925,1982,2020
2020-03-11,Tuesday,3,197,14,99765,113,6305,108122,2052,2020
2020-04-11,Wednesday,4,207,13,99874,109,6318,108329,2137,2020
2020-05-11,Thursday,5,201,11,100006,132,6329,108530,2195,2020
2020-06-11,Friday,6,224,14,100106,100,6343,108754,2305,2020
2020-07-11,Saturday,7,208,12,100239,133,6355,108962,2368,2020
2020-08-11,Sunday,8,239,13,100342,103,6368,109201,2491,2020
2020-09-11,Monday,9,221,12,100439,97,6380,109422,2603,2020
2020-10-11,Tuesday,10,232,14,100540,101,6394,109654,2720,2020
2020-11-11,Wednesday,11,227,11,100662,122,6405,109881,2814,2020
2020-12-11,Thursday,12,214,12,100760,98,6417,110095,2918,2020
2020-11-13,Friday,11,224,12,100847,87,6429,110319,3043,2020
2020-11-14,Saturday,11,228,13,100946,99,6442,110547,3159,2020
2020-11-15,Sunday,11,220,11,101046,100,6453,110767,3268,2020
2020-11-16,Monday,11,242,12,101179,133,6465,111009,3365,2020
2020-11-17,Tuesday,11,275,16,101288,109,6481,111284,3515,2020
2020-11-18,Wednesday,11,329,14,101421,133,6495,111613,3697,2020
2020-11-19,Thursday,11,342,13,101564,143,6508,111955,3883,2020
2020-11-20,Friday,11,363,13,101685,121,6521,112318,4112,2020
2020-11-21,Saturday,11,358,14,101783,98,6535,112676,4358,2020
2020-11-22,Sunday,11,351,13,101881,98,6548,113027,4598,2020
2020-11-23,Monday,11,354,12,101981,100,6560,113381,4840,2020
2020-11-24,Tuesday,11,361,13,102103,122,6573,113742,5066,2020
2020-11-25,Wednesday,11,365,12,102201,98,6585,114107,5321,2020
2020-11-26,Thursday,11,368,11,102268,67,6596,114475,5611,2020
2020-11-27,Friday,11,357,12,102390,122,6608,114832,5834,2020
2020-11-28,Saturday,11,351,13,102490,100,6621,115183,6072,2020
2020-11-29,Sunday,11,358,15,102596,106,6636,115541,6309,2020
2020-11-30,Monday,11,370,14,102718,122,6650,115911,6543,2020
2020-01-12,Tuesday,1,392,16,102816,98,6666,116303,6821,2020
2020-02-12,Wednesday,2,421,28,102949,133,6694,116724,7081,2020
2020-03-12,Thursday,3,432,19,103082,133,6713,117156,7361,2020
2020-04-12,Friday,4,427,19,103191,109,6732,117583,7660,2020
2020-05-12,Saturday,5,431,18,103324,133,6750,118014,7940,2020
2020-06-12,Sunday,6,418,21,103501,177,6771,118432,8160,2020
2020-07-12,Monday,7,415,19,103703,202,6790,118847,8354,2020
2020-08-12,Tuesday,8,434,23,103913,210,6813,119281,8555,2020
2020-09-12,Wednesday,9,421,19,104074,161,6832,119702,8796,2020
2020-10-12,Thursday,10,445,22,104281,207,6854,120147,9012,2020
2020-11-12,Friday,11,464,23,104499,218,6877,120611,9235,2020
2020-12-12,Saturday,12,478,21,104710,211,6898,121089,9481,2020
2020-12-13,Sunday,12,486,22,104875,165,6920,121575,9780,2020
2020-12-14,Monday,12,511,23,105132,257,6943,122086,10011,2020
2020-12-15,Tuesday,12,523,23,105450,318,6966,122609,10193,2020
2020-12-16,Wednesday,12,544,24,105719,269,6990,123153,10444,2020
2020-12-17,Thursday,12,548,25,105919,200,7015,123701,10767,2020
2020-12-18,Friday,12,579,26,106157,238,7041,124280,11082,2020
2020-12-19,Saturday,12,611,28,106481,324,7069,124891,11341,2020
2020-12-20,Sunday,12,664,29,106817,336,7098,125555,11640,2020
2020-12-21,Monday,12,718,32,107162,345,7130,126273,11981,2020
2020-12-22,Tuesday,12,788,37,107563,401,7167,127061,12331,2020
2020-12-23,Wednesday,12,911,42,107961,398,7209,127972,12802,2020
2020-12-24,Thursday,12,1021,51,108474,513,7260,128993,13259,2020
2020-12-25,Friday,12,1133,49,108985,511,7309,130126,13832,2020
2020-12-26,Saturday,12,1189,43,109462,477,7352,131315,14501,2020
2020-12-27,Sunday,12,1226,53,110015,553,7405,132541,15121,2020
2020-12-28,Monday,12,1359,61,110436,421,7466,133900,15998,2020
2020-12-29,Tuesday,12,1333,54,111040,604,7520,135233,16673,2020
2020-12-30,Wednesday,12,1411,56,111451,411,7576,136644,17617,2020
2020-12-31,Thursday,12,1418,55,112105,654,7631,138062,18326,2020
2021-01-01,Friday,1,1409,56,112826,721,7687,139471,18958,2021
2021-02-01,Saturday,2,1407,54,113480,654,7741,140878,19657,2021
2021-03-01,Sunday,3,1309,64,113898,418,7805,142187,20484,2021
2021-04-01,Monday,4,1277,58,114601,703,7863,143464,21000,2021
2021-05-01,Tuesday,5,1119,55,115414,813,7918,144583,21251,2021
2021-06-01,Wednesday,6,1007,57,115975,561,7975,145590,21640,2021
2021-07-01,Thursday,7,1219,54,116775,800,8029,146809,22005,2021
2021-08-01,Friday,8,1001,56,117529,754,8085,147810,22196,2021
2021-09-01,Saturday,9,989,57,118294,765,8142,148799,22363,2021
2021-10-01,Sunday,10,993,55,118900,606,8197,149792,22695,2021
2021-11-01,Monday,11,961,52,119212,312,8249,150753,23292,2021
2021-12-01,Tuesday,12,970,55,119635,423,8304,151723,23784,2021
2021-01-13,Wednesday,1,996,58,120312,677,8362,152719,24045,2021
2021-01-14,Thursday,1,1022,59,121072,760,8421,153741,24248,2021
2021-01-15,Friday,1,879,52,121792,720,8473,154620,24355,2021
2021-01-16,Saturday,1,887,54,122291,499,8527,155507,24689,2021
2021-01-17,Sunday,1,890,56,122993,702,8583,156397,24821,2021
2021-01-18,Monday,1,878,55,123491,498,8638,157275,25146,2021
2021-01-19,Tuesday,1,899,58,124094,603,8696,158174,25384,2021
2021-01-20,Wednesday,1,789,51,124605,511,8747,158963,25611,2021
2021-01-21,Thursday,1,752,54,125171,566,8801,159715,25743,2021
2021-01-22,Friday,1,748,52,125603,432,8853,160463,26007,2021
2021-01-23,Saturday,1,680,49,126176,573,8902,161143,26065,2021
2021-01-24,Sunday,1,674,57,126497,321,8959,161817,26361,2021
2021-01-25,Monday,1,669,53,127001,504,9012,162486,26473,2021
2021-01-26,Tuesday,1,643,55,127433,432,9067,163129,26629,2021
2021-01-27,Wednesday,1,632,48,127963,530,9115,163761,26683,2021
2021-01-28,Thursday,1,521,54,128440,477,9169,164282,26673,2021
2021-01-29,Friday,1,589,48,128800,360,9217,164871,26854,2021
2021-01-30,Saturday,1,547,46,129293,493,9263,165418,26862,2021
2021-01-31,Sunday,1,533,53,129636,343,9316,165951,26999,2021
2021-01-02,Monday,1,541,44,130107,471,9360,166492,27025,2021
2021-02-02,Tuesday,2,521,47,130514,407,9407,167013,27092,2021
2021-03-02,Wednesday,3,512,53,130912,398,9460,167525,27153,2021
2021-04-02,Thursday,4,532,52,131211,299,9512,168057,27334,2021
2021-05-02,Friday,5,540,48,131632,421,9560,168597,27405,2021
2021-06-02,Saturday,6,509,44,132054,422,9604,169106,27448,2021
2021-07-02,Sunday,7,534,47,132375,321,9651,169640,27614,2021
2021-08-02,Monday,8,567,48,132698,323,9699,170207,27810,2021
2021-09-02,Tuesday,9,573,52,133098,400,9751,170780,27931,2021
2021-10-02,Wednesday,10,610,53,133331,233,9804,171390,28255,2021
2021-11-02,Thursday,11,603,53,133707,376,9857,171993,28429,2021
2021-12-02,Friday,12,609,42,134215,508,9899,172602,28488,2021
2021-02-13,Saturday,2,600,36,134638,423,9935,173202,28629,2021
2021-02-14,Sunday,2,611,59,134960,322,9994,173813,28859,2021
2021-02-15,Monday,2,613,56,135349,389,10050,174426,29027,2021
2021-02-16,Tuesday,2,633,51,135670,321,10101,175059,29288,2021
2021-02-17,Wednesday,2,618,49,136081,411,10150,175677,29446,2021
2021-02-18,Thursday,2,656,51,136490,409,10201,176333,29642,2021
2021-02-19,Friday,2,610,49,136889,399,10250,176943,29804,2021
2021-02-20,Saturday,2,600,48,137294,405,10298,177543,29951,2021
2021-02-21,Sunday,2,608,55,137837,543,10353,178151,29961,2021
2021-02-22,Monday,2,623,51,138183,346,10404,178774,30187,2021
2021-02-23,Tuesday,2,633,39,138683,500,10443,179407,30281,2021
2021-02-24,Wednesday,2,644,52,139072,389,10495,180051,30484,2021
2021-02-25,Thursday,2,589,46,139494,422,10541,180640,30605,2021
2021-02-26,Friday,2,601,49,139927,433,10590,181241,30724,2021
2021-02-27,Saturday,2,588,49,140460,533,10639,181829,30730,2021
2021-02-28,Sunday,2,595,49,140892,432,10688,182424,30844,2021
2021-01-03,Monday,1,586,48,141347,455,10736,183010,30927,2021
2021-02-03,Tuesday,2,581,42,141655,308,10778,183591,31158,2021
2021-03-03,Wednesday,3,577,44,142155,500,10822,184168,31191,2021
2021-04-03,Thursday,4,587,49,142610,455,10871,184755,31274,2021
2021-05-03,Friday,5,579,45,143143,533,10916,185334,31275,2021
2021-06-03,Saturday,6,588,38,143575,432,10954,185922,31393,2021
2021-07-03,Sunday,7,581,41,144019,444,10995,186503,31489,2021
2021-08-03,Monday,8,591,43,144485,466,11038,187094,31571,2021
2021-09-03,Tuesday,9,622,44,144917,432,11082,187716,31717,2021
2021-10-03,Wednesday,10,645,46,145418,501,11128,188361,31815,2021
2021-11-03,Thursday,11,639,41,145923,505,11169,189000,31908,2021
2021-12-03,Friday,12,639,45,146434,511,11214,189639,31991,2021
2021-03-13,Saturday,3,641,42,146803,369,11256,190280,32221,2021
2021-03-14,Sunday,3,644,44,147234,431,11300,190924,32390,2021
2021-03-15,Monday,3,631,40,147767,533,11340,191555,32448,2021
2021-03-16,Tuesday,3,640,44,148089,322,11384,192195,32722,2021
2021-03-17,Wednesday,3,645,47,148424,335,11431,192840,32985,2021
2021-03-18,Thursday,3,642,41,148823,399,11472,193482,33187,2021
2021-03-19,Friday,3,645,40,149256,433,11512,194127,33359,2021
2021-03-20,Saturday,3,644,45,149489,233,11557,194771,33725,2021
2021-03-21,Sunday,3,647,41,149934,445,11598,195418,33886,2021
2021-03-22,Monday,3,643,39,150424,490,11637,196061,34000,2021
2021-03-23,Tuesday,3,648,43,150924,500,11680,196709,34105,2021
2021-03-24,Wednesday,3,641,40,151444,520,11720,197350,34186,2021
2021-03-25,Thursday,3,661,48,151765,321,11768,198011,34478,2021
2021-03-26,Friday,3,670,36,152198,433,11804,198681,34679,2021
2021-03-27,Saturday,3,683,41,152642,444,11845,199364,34877,2021
2021-03-28,Sunday,3,686,37,153175,533,11882,200050,34993,2021
2021-03-29,Monday,3,689,32,153630,455,11914,200739,35195,2021
2021-03-30,Tuesday,3,693,42,154194,564,11956,201432,35282,2021
2021-03-31,Wednesday,3,699,39,154694,500,11995,202131,35442,2021
2021-01-04,Thursday,1,712,46,155016,322,12041,202843,35786,2021
2021-02-04,Friday,2,703,43,155448,432,12084,203546,36014,2021
2021-03-04,Saturday,3,710,39,155886,438,12123,204256,36247,2021
2021-04-04,Sunday,4,709,40,156219,333,12163,204965,36583,2021
2021-05-04,Monday,5,767,47,156574,355,12210,205732,36948,2021
2021-06-04,Tuesday,6,778,43,157006,432,12253,206510,37251,2021
2021-07-04,Wednesday,7,783,37,157450,444,12290,207293,37553,2021
2021-08-04,Thursday,8,789,33,157889,439,12323,208082,37870,2021
2021-09-04,Friday,9,794,39,158454,565,12362,208876,38060,2021
2021-10-04,Saturday,10,801,43,159054,600,12405,209677,38218,2021
2021-11-04,Sunday,11,812,40,159499,445,12445,210489,38545,2021
2021-12-04,Monday,12,818,42,159999,500,12487,211307,38821,2021
2021-04-13,Tuesday,4,823,39,160431,432,12526,212130,39173,2021
2021-04-14,Wednesday,4,831,44,161031,600,12570,212961,39360,2021
2021-04-15,Thursday,4,837,41,161470,439,12611,213798,39717,2021
2021-04-16,Friday,4,841,42,162170,700,12653,214639,39816,2021
2021-04-17,Saturday,4,845,41,162714,544,12694,215484,40076,2021
2021-04-18,Sunday,4,850,44,163479,765,12738,216334,40117,2021
2021-04-19,Monday,4,852,40,163812,333,12778,217186,40596,2021
2021-04-20,Tuesday,4,855,42,164368,556,12820,218041,40853,2021
2021-04-21,Wednesday,4,861,46,164803,435,12866,218902,41233,2021
2021-04-22,Thursday,4,872,48,165348,545,12914,219774,41512,2021
2021-04-23,Friday,4,884,45,166024,676,12959,220658,41675,2021
2021-04-24,Saturday,4,912,39,166457,433,12998,221570,42115,2021
2021-04-25,Sunday,4,953,51,167024,567,13049,222523,42450,2021
2021-04-26,Monday,4,991,58,167900,876,13107,223514,42507,2021
2021-04-27,Tuesday,4,1003,61,168665,765,13168,224517,42684,2021
2021-04-28,Wednesday,4,1011,51,169308,643,13219,225528,43001,2021
2021-04-29,Thursday,4,1003,59,170008,700,13278,226531,43245,2021
2021-04-30,Friday,4,1021,61,170773,765,13339,227552,43440,2021
2021-01-05,Saturday,1,1032,63,171542,769,13402,228584,43640,2021
2021-02-05,Sunday,2,1051,67,172342,800,13469,229635,43824,2021
2021-03-05,Monday,3,1078,62,172774,432,13531,230713,44408,2021
2021-04-05,Tuesday,4,1090,60,173341,567,13591,231803,44871,2021
2021-05-05,Wednesday,5,1102,64,174217,876,13655,232905,45033,2021
2021-06-05,Thursday,6,1110,59,175117,900,13714,234015,45184,2021
2021-07-05,Friday,7,1125,65,175928,811,13779,235140,45433,2021
2021-08-05,Saturday,8,1132,66,176363,435,13845,236272,46064,2021
2021-09-05,Sunday,9,1138,59,176763,400,13904,237410,46743,2021
2021-10-05,Monday,10,1150,68,177440,677,13972,238560,47148,2021
2021-11-05,Tuesday,11,1180,61,178241,801,14033,239740,47466,2021
2021-12-05,Wednesday,12,1187,58,178805,564,14091,240927,48031,2021
2021-05-13,Thursday,5,1193,59,179261,456,14150,242120,48709,2021
2021-05-14,Friday,5,1197,56,179817,556,14206,243317,49294,2021
2021-05-15,Saturday,5,1203,63,180577,760,14269,244520,49674,2021
2021-05-16,Sunday,5,1201,58,181478,901,14327,245721,49916,2021
2021-05-17,Monday,5,1188,61,182024,546,14388,246909,50497,2021
2021-05-18,Tuesday,5,1169,53,182693,669,14441,248078,50944,2021
2021-05-19,Wednesday,5,1160,57,183696,1003,14498,249238,51044,2021
2021-05-20,Thursday,5,1153,61,184373,677,14559,250391,51459,2021
2021-05-21,Friday,5,1148,52,185243,870,14611,251539,51685,2021
2021-05-22,Saturday,5,1151,59,186223,980,14670,252690,51797,2021
2021-05-23,Sunday,5,1145,51,186678,455,14721,253835,52436,2021
2021-05-24,Monday,5,1149,45,187446,768,14766,254984,52772,2021
2021-05-25,Tuesday,5,1140,41,187691,245,14807,256124,53626,2021
2021-05-26,Wednesday,5,1151,43,188567,876,14850,257275,53858,2021
2021-05-27,Thursday,5,1132,54,189476,909,14904,258407,54027,2021
2021-05-28,Friday,5,1133,46,190254,778,14950,259540,54336,2021
2021-05-29,Saturday,5,1119,51,190733,479,15001,260659,54925,2021
2021-05-30,Sunday,5,1007,46,191475,742,15047,261666,55144,2021
2021-05-31,Monday,5,984,49,192112,637,15096,262650,55442,2021
2021-01-06,Tuesday,1,956,40,192823,711,15136,263606,55647,2021
2021-02-06,Wednesday,2,951,42,193491,668,15178,264557,55888,2021
2021-03-06,Thursday,3,932,44,194291,800,15222,265489,55976,2021
2021-04-06,Friday,4,861,46,195072,781,15268,266350,56010,2021
2021-05-06,Saturday,5,821,41,195871,799,15309,267171,55991,2021
2021-06-06,Sunday,6,801,43,196604,733,15352,267972,56016,2021
2021-07-06,Monday,7,782,47,197281,677,15399,268754,56074,2021
2021-08-06,Tuesday,8,773,38,197832,551,15437,269527,56258,2021
2021-09-06,Wednesday,9,765,34,198632,800,15471,270292,56189,2021
2021-10-06,Thursday,10,755,39,199285,653,15510,271047,56252,2021
2021-11-06,Friday,11,733,37,199840,555,15547,271780,56393,2021
2021-12-06,Saturday,12,711,35,200273,433,15582,272491,56636,2021
2021-06-13,Sunday,6,691,41,201038,765,15623,273182,56521,2021
2021-06-14,Monday,6,613,31,201739,701,15654,273795,56402,2021
2021-06-15,Tuesday,6,609,37,202650,911,15691,274404,56063,2021
2021-06-16,Wednesday,6,606,32,203193,543,15723,275010,56094,2021
2021-06-17,Thursday,6,591,37,203802,609,15760,275601,56039,2021
2021-06-18,Friday,6,589,31,204701,899,15791,276190,55698,2021
2021-06-19,Saturday,6,566,38,205157,456,15829,276756,55770,2021
2021-06-20,Sunday,6,532,30,205613,456,15859,277288,55816,2021
2021-06-21,Monday,6,509,39,206053,440,15898,277797,55846,2021
2021-06-22,Tuesday,6,498,37,206852,799,15935,278295,55508,2021
2021-06-23,Wednesday,6,466,32,207411,559,15967,278761,55383,2021
2021-06-24,Thursday,6,423,35,208192,781,16002,279184,54990,2021
2021-06-25,Friday,6,412,29,208957,765,16031,279596,54608,2021
2021-06-26,Saturday,6,409,31,209395,438,16062,280005,54548,2021
2021-06-27,Sunday,6,389,30,210052,657,16092,280394,54250,2021
2021-06-28,Monday,6,376,33,210482,430,16125,280770,54163,2021
2021-06-29,Tuesday,6,261,23,210805,323,16148,281031,54078,2021
2021-06-30,Wednesday,6,251,21,211384,579,16169,281282,53729,2021
2021-01-07,Thursday,1,242,25,212059,675,16194,281524,53271,2021
2021-02-07,Friday,2,198,21,212725,666,16215,281722,52782,2021
2021-03-07,Saturday,3,181,27,213628,903,16242,281903,52033,2021
2021-04-07,Sunday,4,179,22,214087,459,16264,282082,51731,2021
2021-05-07,Monday,5,175,20,214852,765,16284,282257,51121,2021
2021-06-07,Tuesday,6,164,22,215419,567,16306,282421,50696,2021
2021-07-07,Wednesday,7,161,26,216217,798,16332,282582,50033,2021
2021-08-07,Thursday,8,155,19,216982,765,16351,282737,49404,2021
2021-09-07,Friday,9,127,17,217324,342,16368,282864,49172,2021
2021-10-07,Saturday,10,121,15,217756,432,16383,282985,48846,2021
2021-11-07,Sunday,11,117,13,218412,656,16396,283102,48294,2021
2021-12-07,Monday,12,110,7,219291,879,16403,283212,47518,2021
2021-07-13,Tuesday,7,108,9,219525,234,16412,283320,47383,2021
2021-07-14,Wednesday,7,89,6,220530,1005,16418,283409,46461,2021
2021-07-15,Thursday,7,81,7,221516,986,16425,283490,45549,2021
2021-07-16,Friday,7,77,6,222315,799,16431,283567,44821,2021
2021-07-17,Saturday,7,69,8,223213,898,16439,283636,43984,2021
2021-07-18,Sunday,7,67,7,223645,432,16446,283703,43612,2021
2021-07-19,Monday,7,59,6,224299,654,16452,283762,43011,2021
2021-07-20,Tuesday,7,51,5,225068,769,16457,283813,42288,2021
2021-07-21,Wednesday,7,49,8,225869,801,16465,283862,41528,2021
2021-07-22,Thursday,7,44,5,226535,666,16470,283906,40901,2021
2021-07-23,Friday,7,41,7,227068,533,16477,283947,40402,2021
2021-07-24,Saturday,7,38,4,227490,422,16481,283985,40014,2021
2021-07-25,Sunday,7,39,6,227612,122,16487,284024,39925,2021
2021-07-26,Monday,7,35,7,227970,358,16494,284059,39595,2021
2021-07-27,Tuesday,7,31,4,228624,654,16498,284090,38968,2021
2021-07-28,Wednesday,7,38,9,228836,212,16507,284128,38785,2021
2021-07-29,Thursday,7,42,7,229167,331,16514,284170,38489,2021
2021-07-30,Friday,7,45,4,229712,545,16518,284215,37985,2021
2021-07-31,Saturday,7,47,6,230368,656,16524,284262,37370,2021
2021-01-08,Sunday,1,49,4,230699,331,16528,284311,37084,2021
2021-02-08,Monday,2,51,7,231259,560,16535,284362,36568,2021
2021-03-08,Tuesday,3,53,5,232060,801,16540,284415,35815,2021
2021-04-08,Wednesday,4,57,10,232179,119,16550,284472,35743,2021
2021-05-08,Thursday,5,51,7,232280,101,16557,284523,35686,2021
2021-06-08,Friday,6,57,5,232601,321,16562,284580,35417,2021
2021-07-08,Saturday,7,61,4,232825,224,16566,284641,35250,2021
2021-08-08,Sunday,8,65,9,233227,402,16575,284706,34904,2021
2021-09-08,Monday,9,83,7,233298,71,16582,284789,34909,2021
2021-10-08,Tuesday,10,86,6,233405,107,16588,284875,34882,2021
2021-11-08,Wednesday,11,91,9,233517,112,16597,284966,34852,2021
2021-12-08,Thursday,12,95,7,233729,212,16604,285061,34728,2021
2021-08-13,Friday,8,97,5,233772,43,16609,285158,34777,2021
2021-08-14,Saturday,8,99,6,233881,109,16615,285257,34761,2021
2021-08-15,Sunday,8,101,4,234114,233,16619,285358,34625,2021
2021-08-16,Monday,8,107,6,234250,136,16625,285465,34590,2021
